0000001101
1011101101
1000100001
1110111011
1000011011
1001000001
1100111101
1101000101
*001010001
1010000011