0010000101
1010110101
0000110001
1110011101
1000010000
1011100110
1000110100
1010101001
1000001000
100110000*

